ক	k
খ	K
গ	g
ঘ	G
ঙ	z
চ	c
ছ	s
জ	j
ঝ	J
ঞ	Z
ট	T
ঠ	Th
ড	D
ঢ	Dh
ণ	N
ত	t
থ	th
দ	d
ধ	dh
ন	n
প	p
ফ	f
ব	b
ভ	v
ম	m
য	y
র	r
ল	l
শ	S
ষ	X
স	s
হ	h
া	a
ি	i
ী	ii
ু	u
ূ	uu
ে	e
ৈ	ei
ো	o
ৌ	ou
ং	M
ঃ	H
ঁ	N